1111111111111111111
10000000000000XC001
1010010100100000101
1010010011101010001
1P1000000C00C0000E1
1111111111111111111
